EWEEEEEEEE
EEEEEEEEEE
EEWEEEEEEE
EEEEEEEAEE
EEEEEEEEEE
EEEEEEEEEE
EEEWEEEEEE
EWEDEEEEEE
EEEEWEEEEE
EEEWEEEEEE